101111111101010111010110111010101111111101\n
100000000001010000010010000010100000000001\n
100111011100010101111011101010001110111031\n
101100000110110101110011101011011000001101\n
101001110010110000110111000011010011100101\n
101011111010110110110011011011010111110101\n
101001110010110110111011011011010011100101\n
101100000110110111000000111011011000001101\n
000111011100010011011110110010001110111000\n
110000000001000000000000000000100000000011\n
110111111111110100101101001011111111111011\n
111111111110110101101101101011011111111111\n
000000000000000000101101000000000000000000\n
111110111110101010000000010101011111011111\n
000000100000101010111111010101000001000000\n
111010101111101010101101010101111101010111\n
111000001110001000001100000100011100000111\n
001111111110101101101101101101011111111100\n
100000110000000000000000000000000011000001\n
101110100110111110110011011111011001011101\n
101110101110111110111011011111011101011101\n
101000101100010000010010000010001101000101\n
121011101101011111010110111110101101110101\n
000000001101000111010010111000101100000000\n
101111111101010111011010111010101111111101\n
