101111111101011111101110101011110111111111
101111111101010001101110001010000111111111
000000000000010100001111111010110100000030
111111111110100101101111111010110101111111
100000000010101100100000000010010101000001
101110111010101110101110111011110101011101
101110111010100000101000001000000101000101
001110111010111011101011101011111101010100
101100011010111011100011100010000001000101
101101011010000000001011101010111011111101
100001000010111111101000001010001000000001
111101011110111111101110111011101111111111
000000000000000000000000000000000000000000
111111011110101111010101011111111101110111
000001001110101111010101011000000101110000
111011101110101111010101011011110100011011
111001001110101100000100001000010001011001
001100011110101101111111101111011111011100
101110110000100000000000101000010000000001
101110100110111111111110101011110111011111
101110101110111111011000101001110111000001
101000101100010000000010101100000111111101
121011101101011111011010101110110100010000
100000001101011111000010100010110001000111
101111111101011111101110101010110111111111
