101101011011010111010101010111110111111101\n
101101011011010000010101010100000111111101\n
000001000011011111010101010101110111000030\n
101111111011011000010101010101110111011111\n
100000000010001011010000000101110111000001\n
111110111111011011011101011101110111011101\n
000000111111011011010000000000000111011100\n
111110111111011011010110110111111111011101\n
100000000000011000011111111110000001000001\n
101101011011011011000011100010111101101101\n
101100011011011011101000001010001100000001\n
101110111011011011101110111011101111111111\n
000000001000001000000000000011100000000000\n
111111101110101111011111011111111101101111\n
000001101110101000011111011000000101100000\n
111101101000101011111111011011110101111111\n
111101101010101000001000011000010001111111\n
000000001010101101111111011111011111111100\n
111110111010100000001000011000010000000001\n
111110100000110111111101011011110111011111\n
111110101110110111111001011011110001000001\n
111100101110110110000011010000000111111101\n
020001101110110110111011010111110111110000\n
101100001000010110000000010111110000000101\n
101101011011010111010111010111110111111101\n
