101101011011010111010101010111110111111101
101101011011010000010101010100000111111101
000001000011011111010101010101110111000030
101111111011011000010101010101110111011111
100000000010001011010000000101110111000001
111110111111011011011101011101110111011101
000000111111011011010000000000000111011100
111110111111011011010110110111111111011101
100000000000011000011111111110000001000001
101101011011011011000011100010111101101101
101100011011011011101000001010001100000001
101110111011011011101110111011101111111111
000000001000001000000000000011100000000000
111111101110101111011111011111111101101111
000001101110101000011111011000000101100000
111101101000101011111111011011110101111111
111101101010101000001000011000010001111111
000000001010101101111111011111011111111100
111110111010100000001000011000010000000001
111110100000110111111101011011110111011111
111110101110110111111001011011110001000001
111100101110110110000011010000000111111101
020001101110110110111011010111110111110000
101100001000010110000000010111110000000101
101101011011010111010111010111110111111101
